-1.000000000000000000e+00 -6.364458203315734863e-01 -7.541847825050354004e-01 1.000000000000000000e+00 -1.000000000000000000e+00 -1.000000000000000000e+00 -1.000000000000000000e+00 1.000000000000000000e+00 1.000000000000000000e+00 -9.319579005241394043e-01 1.000000000000000000e+00 1.000000000000000000e+00 -1.000000000000000000e+00 -1.000000000000000000e+00 1.000000000000000000e+00 1.000000000000000000e+00
-1.000000000000000000e+00 -7.476906776428222656e-01 -7.883229851722717285e-01 1.000000000000000000e+00 -1.000000000000000000e+00 -1.000000000000000000e+00 -1.000000000000000000e+00 1.000000000000000000e+00 1.000000000000000000e+00 -9.839592576026916504e-01 1.000000000000000000e+00 1.000000000000000000e+00 -1.000000000000000000e+00 -1.000000000000000000e+00 1.000000000000000000e+00 1.000000000000000000e+00
-1.000000000000000000e+00 -6.825740933418273926e-01 -7.991703152656555176e-01 1.000000000000000000e+00 -1.000000000000000000e+00 -1.000000000000000000e+00 -1.000000000000000000e+00 1.000000000000000000e+00 1.000000000000000000e+00 -9.714681506156921387e-01 1.000000000000000000e+00 1.000000000000000000e+00 -1.000000000000000000e+00 -1.000000000000000000e+00 1.000000000000000000e+00 1.000000000000000000e+00
-1.000000000000000000e+00 -6.313799619674682617e-01 -8.034756779670715332e-01 1.000000000000000000e+00 -1.000000000000000000e+00 -1.000000000000000000e+00 -1.000000000000000000e+00 1.000000000000000000e+00 1.000000000000000000e+00 -9.618735909461975098e-01 1.000000000000000000e+00 1.000000000000000000e+00 -1.000000000000000000e+00 -1.000000000000000000e+00 1.000000000000000000e+00 1.000000000000000000e+00
-1.000000000000000000e+00 -6.053959131240844727e-01 -8.056055903434753418e-01 1.000000000000000000e+00 -1.000000000000000000e+00 -1.000000000000000000e+00 -1.000000000000000000e+00 1.000000000000000000e+00 1.000000000000000000e+00 -9.566621780395507812e-01 1.000000000000000000e+00 1.000000000000000000e+00 -1.000000000000000000e+00 -1.000000000000000000e+00 1.000000000000000000e+00 1.000000000000000000e+00
-1.000000000000000000e+00 -5.905985236167907715e-01 -8.068307638168334961e-01 1.000000000000000000e+00 -1.000000000000000000e+00 -1.000000000000000000e+00 -1.000000000000000000e+00 1.000000000000000000e+00 1.000000000000000000e+00 -9.535850882530212402e-01 1.000000000000000000e+00 1.000000000000000000e+00 -1.000000000000000000e+00 -1.000000000000000000e+00 1.000000000000000000e+00 1.000000000000000000e+00
1.000000000000000000e+00 3.776047229766845703e-01 5.916923284530639648e-01 -7.082633972167968750e-01 -3.882614374160766602e-01 2.637340426445007324e-01 -6.691776514053344727e-01 -6.368034482002258301e-01 -1.000000000000000000e+00 7.872353792190551758e-01 -1.313490867614746094e-01 -8.876009285449981689e-02 4.410950243473052979e-01 2.641027867794036865e-01 -9.708697795867919922e-01 -1.631328463554382324e-01
1.000000000000000000e+00 2.301554083824157715e-01 5.639418959617614746e-01 -6.794056892395019531e-01 -5.290414094924926758e-01 3.278211057186126709e-01 -5.378655195236206055e-01 -6.946296691894531250e-01 -1.000000000000000000e+00 8.304721713066101074e-01 -6.583157926797866821e-02 -9.629259258508682251e-02 4.514338970184326172e-01 1.270609498023986816e-01 -9.100087881088256836e-01 -2.256674468517303467e-01
1.000000000000000000e+00 2.737485170364379883e-01 5.391998291015625000e-01 -6.718445420265197754e-01 -4.599011540412902832e-01 2.953884601593017578e-01 -5.868043899536132812e-01 -6.393768787384033203e-01 -1.000000000000000000e+00 8.003168106079101562e-01 -8.356276899576187134e-02 -1.057947278022766113e-01 4.259730279445648193e-01 1.732520163059234619e-01 -9.167538285255432129e-01 -2.115820795297622681e-01
1.000000000000000000e+00 2.915591895580291748e-01 5.355520844459533691e-01 -6.664847135543823242e-01 -4.377597570419311523e-01 2.740660607814788818e-01 -6.058700084686279297e-01 -6.194108128547668457e-01 -1.000000000000000000e+00 7.894060611724853516e-01 -8.990710228681564331e-02 -1.074370741844177246e-01 4.152779877185821533e-01 1.850895434617996216e-01 -9.214379787445068359e-01 -2.092017084360122681e-01
1.000000000000000000e+00 3.098988831043243408e-01 5.308303236961364746e-01 -6.620978713035583496e-01 -4.141337871551513672e-01 2.554844915866851807e-01 -6.255539655685424805e-01 -5.985324978828430176e-01 -1.000000000000000000e+00 7.778356075286865234e-01 -9.706361591815948486e-02 -1.103715524077415466e-01 4.046564996242523193e-01 1.995836049318313599e-01 -9.255664944648742676e-01 -2.052595019340515137e-01
1.000000000000000000e+00 3.239714801311492920e-01 5.257995128631591797e-01 -6.567618846893310547e-01 -3.942481279373168945e-01 2.385729849338531494e-01 -6.405348181724548340e-01 -5.798590183258056641e-01 -1.000000000000000000e+00 7.662702798843383789e-01 -1.023283451795578003e-01 -1.130826175212860107e-01 3.949962556362152100e-01 2.096036076545715332e-01 -9.274271726608276367e-01 -2.024239301681518555e-01
1.000000000000000000e+00 2.570057511329650879e-01 5.717797875404357910e-01 6.091009974479675293e-01 -2.095893211662769318e-02 1.000000000000000000e+00 1.429817825555801392e-01 -1.000000000000000000e+00 -4.246665835380554199e-01 -6.431565880775451660e-01 -4.068927764892578125e-01 1.000000000000000000e+00 -3.435899913311004639e-01 -1.000000000000000000e+00 6.712321043014526367e-01 8.745339512825012207e-01
1.000000000000000000e+00 2.489569485187530518e-01 6.025161147117614746e-01 6.059292554855346680e-01 1.074010878801345825e-02 1.000000000000000000e+00 1.159677878022193909e-01 -1.000000000000000000e+00 -4.265982806682586670e-01 -6.656982898712158203e-01 -4.284135103225708008e-01 1.000000000000000000e+00 -3.729679286479949951e-01 -1.000000000000000000e+00 6.717410683631896973e-01 8.728905916213989258e-01
1.000000000000000000e+00 2.516165673732757568e-01 6.017016172409057617e-01 6.043505072593688965e-01 7.772397249937057495e-03 1.000000000000000000e+00 1.212307810783386230e-01 -1.000000000000000000e+00 -4.261332154273986816e-01 -6.646459698677062988e-01 -4.314736127853393555e-01 1.000000000000000000e+00 -3.730381727218627930e-01 -1.000000000000000000e+00 6.761379837989807129e-01 8.801831007003784180e-01
1.000000000000000000e+00 2.545222640037536621e-01 6.005998253822326660e-01 6.024994254112243652e-01 4.275581799447536469e-03 1.000000000000000000e+00 1.269506514072418213e-01 -1.000000000000000000e+00 -4.261013567447662354e-01 -6.639274954795837402e-01 -4.342228472232818604e-01 1.000000000000000000e+00 -3.733044266700744629e-01 -1.000000000000000000e+00 6.795608997344970703e-01 8.866260647773742676e-01
1.000000000000000000e+00 2.576854825019836426e-01 5.993041396141052246e-01 6.004109382629394531e-01 3.585147205740213394e-04 1.000000000000000000e+00 1.332956999540328979e-01 -1.000000000000000000e+00 -4.260719418525695801e-01 -6.630768179893493652e-01 -4.371992349624633789e-01 1.000000000000000000e+00 -3.734933435916900635e-01 -1.000000000000000000e+00 6.833270192146301270e-01 8.936831355094909668e-01
1.000000000000000000e+00 2.612839341163635254e-01 5.977242588996887207e-01 5.979462862014770508e-01 -4.145949147641658783e-03 1.000000000000000000e+00 1.404870003461837769e-01 -1.000000000000000000e+00 -4.260881543159484863e-01 -6.620221734046936035e-01 -4.404061138629913330e-01 1.000000000000000000e+00 -3.736191987991333008e-01 -1.000000000000000000e+00 6.873674392700195312e-01 9.014648795127868652e-01
