-1.000000000000000000e+00 -2.406074553728103638e-01 -9.161165952682495117e-01 -6.265168190002441406e-01 -7.975721359252929688e-01 1.000000000000000000e+00 -6.710907816886901855e-01 1.000000000000000000e+00 -1.940426677465438843e-01 -1.000000000000000000e+00 -9.003844261169433594e-01 3.551834225654602051e-01 2.379917800426483154e-01 1.000000000000000000e+00 -2.940310835838317871e-01 -1.408362239599227905e-01
-1.000000000000000000e+00 -2.520031332969665527e-01 -9.828008413314819336e-01 -6.799706816673278809e-01 -8.463484048843383789e-01 1.000000000000000000e+00 -7.219935059547424316e-01 1.000000000000000000e+00 -1.944147050380706787e-01 -1.000000000000000000e+00 -9.419347643852233887e-01 3.797467947006225586e-01 2.589198052883148193e-01 1.000000000000000000e+00 -2.847204506397247314e-01 -1.565785259008407593e-01
-1.000000000000000000e+00 -2.508570253849029541e-01 -9.817327857017517090e-01 -6.788860559463500977e-01 -8.465458750724792480e-01 1.000000000000000000e+00 -7.217586636543273926e-01 1.000000000000000000e+00 -1.969910264015197754e-01 -1.000000000000000000e+00 -9.421526193618774414e-01 3.781873583793640137e-01 2.634960412979125977e-01 1.000000000000000000e+00 -2.828840017318725586e-01 -1.560484170913696289e-01
-1.000000000000000000e+00 -2.505128979682922363e-01 -9.812386035919189453e-01 -6.784188747406005859e-01 -8.464070558547973633e-01 1.000000000000000000e+00 -7.214670181274414062e-01 1.000000000000000000e+00 -1.976893544197082520e-01 -1.000000000000000000e+00 -9.419425725936889648e-01 3.776112496852874756e-01 2.645979225635528564e-01 1.000000000000000000e+00 -2.824976146221160889e-01 -1.557948440313339233e-01
-1.000000000000000000e+00 -2.502537071704864502e-01 -9.807349443435668945e-01 -6.778573989868164062e-01 -8.460648655891418457e-01 1.000000000000000000e+00 -7.211102247238159180e-01 1.000000000000000000e+00 -1.981747150421142578e-01 -1.000000000000000000e+00 -9.417074322700500488e-01 3.771264255046844482e-01 2.654011249542236328e-01 1.000000000000000000e+00 -2.822993993759155273e-01 -1.555639654397964478e-01
-1.000000000000000000e+00 -2.500224709510803223e-01 -9.803791046142578125e-01 -6.773631572723388672e-01 -8.458436131477355957e-01 1.000000000000000000e+00 -7.208518385887145996e-01 1.000000000000000000e+00 -1.986972540616989136e-01 -1.000000000000000000e+00 -9.417409896850585938e-01 3.767024874687194824e-01 2.662784755229949951e-01 1.000000000000000000e+00 -2.822217047214508057e-01 -1.553917080163955688e-01
1.000000000000000000e+00 -1.000000000000000000e+00 5.787942409515380859e-01 3.561549484729766846e-01 1.754728704690933228e-01 1.000000000000000000e+00 -7.435705661773681641e-01 -7.644070982933044434e-01 8.809662461280822754e-01 -3.180157542228698730e-01 -1.000000000000000000e+00 -1.384859085083007812e-01 -1.000000000000000000e+00 1.000000000000000000e+00 6.549068689346313477e-01 1.753916889429092407e-01
1.000000000000000000e+00 -1.000000000000000000e+00 5.405269861221313477e-01 3.533041775226593018e-01 1.855322271585464478e-01 1.000000000000000000e+00 -6.391229629516601562e-01 -7.461179494857788086e-01 8.211034536361694336e-01 -3.116384744644165039e-01 -1.000000000000000000e+00 -1.230345889925956726e-01 -1.000000000000000000e+00 1.000000000000000000e+00 6.129733920097351074e-01 2.615932226181030273e-01
1.000000000000000000e+00 -1.000000000000000000e+00 5.375677347183227539e-01 3.522262275218963623e-01 1.866430491209030151e-01 1.000000000000000000e+00 -6.328883767127990723e-01 -7.408161759376525879e-01 8.127833604812622070e-01 -3.096587657928466797e-01 -1.000000000000000000e+00 -1.250177472829818726e-01 -1.000000000000000000e+00 1.000000000000000000e+00 6.072940826416015625e-01 2.608790695667266846e-01
1.000000000000000000e+00 -1.000000000000000000e+00 5.336666107177734375e-01 3.511065542697906494e-01 1.881254613399505615e-01 1.000000000000000000e+00 -6.255353689193725586e-01 -7.363715171813964844e-01 8.044860363006591797e-01 -3.070929944515228271e-01 -1.000000000000000000e+00 -1.262167841196060181e-01 -1.000000000000000000e+00 1.000000000000000000e+00 6.018394827842712402e-01 2.624184787273406982e-01
1.000000000000000000e+00 -1.000000000000000000e+00 5.310992002487182617e-01 3.505343496799468994e-01 1.890601366758346558e-01 1.000000000000000000e+00 -6.199701428413391113e-01 -7.340974807739257812e-01 7.995815873146057129e-01 -3.057369589805603027e-01 -1.000000000000000000e+00 -1.273228824138641357e-01 -1.000000000000000000e+00 1.000000000000000000e+00 5.976811647415161133e-01 2.639524638652801514e-01
1.000000000000000000e+00 -1.000000000000000000e+00 5.273306965827941895e-01 3.494409918785095215e-01 1.900569051504135132e-01 1.000000000000000000e+00 -6.128266453742980957e-01 -7.302752137184143066e-01 7.923910617828369141e-01 -3.035752475261688232e-01 -1.000000000000000000e+00 -1.283997893333435059e-01 -1.000000000000000000e+00 1.000000000000000000e+00 5.923271179199218750e-01 2.652134597301483154e-01
1.000000000000000000e+00 -1.000000000000000000e+00 1.000000000000000000e+00 1.000000000000000000e+00 -6.692885160446166992e-01 1.000000000000000000e+00 -7.674651145935058594e-01 -1.000000000000000000e+00 -7.630906105041503906e-01 -5.227586030960083008e-01 7.434964179992675781e-01 -2.996065020561218262e-01 -5.355501174926757812e-01 -1.000000000000000000e+00 6.549129486083984375e-01 2.915836572647094727e-01
1.000000000000000000e+00 -1.000000000000000000e+00 9.891393780708312988e-01 1.000000000000000000e+00 -6.418130993843078613e-01 9.860693216323852539e-01 -5.945188999176025391e-01 -1.000000000000000000e+00 -7.129068970680236816e-01 -4.638421535491943359e-01 7.506921291351318359e-01 -2.111617475748062134e-01 -5.414090752601623535e-01 -9.381529092788696289e-01 4.496785998344421387e-01 1.111476123332977295e-01
1.000000000000000000e+00 -1.000000000000000000e+00 1.000000000000000000e+00 1.000000000000000000e+00 -6.394871473312377930e-01 9.907488226890563965e-01 -6.051305532455444336e-01 -1.000000000000000000e+00 -7.035340070724487305e-01 -4.634921848773956299e-01 7.427916526794433594e-01 -2.139350026845932007e-01 -5.340172052383422852e-01 -9.398788213729858398e-01 4.619291424751281738e-01 1.258886754512786865e-01
1.000000000000000000e+00 -1.000000000000000000e+00 9.996973276138305664e-01 1.000000000000000000e+00 -6.366844177246093750e-01 9.824895262718200684e-01 -6.051166653633117676e-01 -1.000000000000000000e+00 -6.893162131309509277e-01 -4.571231305599212646e-01 7.355844378471374512e-01 -2.074483782052993774e-01 -5.236436128616333008e-01 -9.285430312156677246e-01 4.600632786750793457e-01 1.262879520654678345e-01
